EA ./assets/textures/wood.xpm

F 20,100,0
C 25,30,0

        1111111111111111111111111
        100000000011000000000000111
        101100000111000000000000001
        100100000000000000000000111
111111111011000001110000000000001
1000S0000011000001110111111111111
11110111111111000000000010001
1111D111111111011101010010001
11000000110101011100000010001
10000000000000000000000000001
10000000000000001101010010001
11000001110101011111011110001
11110111 1110101 101111010001
11110111 1111111 111111111111
   101
   111
