1111111111111111111111111111111111
1001000000000000000000000000000001
1001000000000000000000000000000001
1001000000000000000000000000000001
1001000000010000000000010000000001
1000000000010000000000010000000001
1000000000010000000000010000000001
1000000000010000000000010000000001
1000000000010000000000010000000001
1000000000010000000000010000000001
1000000000000000000000010000000001
1000N00000000000000000010000000001
1111111111111111111111111111111111
