F 220,100,0
C 225,30,0

1111111111111111111111111111111111
1001000000000000000000000000000001
1001000000000000000000000000000001
1001000000000000000000000000000001
1001000000010000000000010000000001
1000000000010000E00000010000000001
1000000000010000000000010000000001
1000000000010000000000010000000001
1000000000010000000000010000000001
1000000000010000000000010000000001
1000000000000000000000010000000001
1000000000000000000000010000000001
1111111111111111111111111111111111
