NO ./assets/textures/wood.xpm
SO ./assets/textures/wood.xpm
EA ./assets/textures/wood.xpm
WE ./assets/textures/wood.xpm
D ./assets/textures/door_default.xpm
F 20,100,10
C 51,50,51
             111       1111
             101       1001
        1111110111111111001111111
        100000000011000000000000111
        10110S000111000000000000001
        100100000000000000000000111
1111111110110000011100000000000001
1000000000110000011101111111111111
11110111111111000000000010001
1111D111111111011101010010001
11100000110101011100000010001
11111111111111111111111111111

11111111111111111111111111111
10000000000000000000000000001
10000000000000001001010010001
11000001110101011101010010001
11110111 1010101 101010010001
11110111 1111111 111111111111
   101
   111
